7 6 8
00020003
01111111
01010201
20000101
11111101
00002001

61711003
61217010
21011210
22002010
11112110
40000000

00080080
81111110
01110310
07776118
11111110
40080080

7db810a3
c18a101a
111d1800
17c8861d
11111119
409a7008

981890d3
1adc1a11
181a1g16
ca1a1f1b
111a101b
40e900d8

111j1iii
kaaa1i1i
11d11iii
bhh91l1d
11d111dd
400ab003

9bdhhh99
1110111d
ca101369
ac1g11bd
1d1f911d
400a90a0
