q1p11Co3
E1EE11u1
oo1u1bE1
u1FoEC0E
qu11111u
40C0o0DF
