00080080
81111110
01110310
07776118
11111110
40080080
