00020003
01111111
01010201
20000101
11111101
00002001
