61711003
61217010
21011210
22002010
11112110
40000000
