11111111
1syaays1
1y1111y1
1z1001z1
1y1001y1
40B00BA3
