LM1C1q1F
v11z1KNK
vG1G11u1
GEuNOuEF
111P1111
40G0uN03
