981890d3
1adc1a11
181a1g16
ca1a1f1b
111a101b
40e900d8
